A00001111000101
001110000011111
100001110001111
000111000110000
000001111010101
101011110000101
110010010000000
010010010010000
001001001001001
100100100101001
001001010010000
000011110010100
010010010000000
000000000100100
00100100100000B