A10000001000000
010000000000010
010000000000010
010000000000010
011110000000010
000010000000010
000010000000010
000010000000010
000010000000010
000010000000010
000010000000010
000011111111010
000000000000010
111111111111110
00000000000000B